Пыли:
    S:itemGroup.dustDiv72=1/72ая Пыли
	S:oredict.dustDiv72AntiChlorine.name=1/72ая часть Пыли Анти-Хлора
		
Impure Pile of Anti-Cerium Dust - Неочищенная Пыль Анти-Хлора
	
Purified Pile of Anti-Cerium Dust - Очищенная Пыль Анти-Хлора
	
Small Pile of Anti-Cerium Dust - Микро Пыль Анти-Хлора
	
Tiny Pile of Anti-Cerium Dust - Нано Пыль Анти-Хлора
	
Tin Dust - Оловянная пыль


Общее сокращение:

1/72nd - 1/72ая
Small - 1/4ая
Tiny - 1/9ая

Для пылей 1/nая часть

Слитки:
Tin Ingot - Слиток Олова

Crate of Annealed Copper Ingot - Ящик Слитков Прокаленной Меди

Crate of Annealed Copper Plate - Ящик Пластин Прокаленной Меди


Руда:

Crushed Anti-Copper Ore - Дробленая Руда Анти-Меди
Refined Anti-Copper Ore - Переработанная  Рафинированная
Purified - Очищенная


Chunk - Кусок

Trinitanium - Тринитан
Vibramantium - Вибрамант


Sifter - Просеиватель
Просеивательный Стол Sifting Table

Tungsten Carbide - Карбид Вольфрама

Вольтажи:
ULV - УНВ - Ультра Низкий Вольтаж
LV - НВ - Низкий Вольтаж
MV - СВ - Средний Вольтаж
HV - ВВ - Высокий Вольтаж
EV - ЭВ - Экстримальный Вольтаж
IV - БВ - Безумный Вольтаж



Double - Двойная
Triple - Тройной
Quadruple - Четверной
Quintuple - Пятикратный